XXXXXXXXXXXXXXXXXXXX
X                  X
XXXXXXXXX XXXXXXXX X
X                  X
X XXX XXXXXXXXXXXXXX
X                  X
XXXXXXXXXXX XXXXXX X
X                  X
X XXXXXX XXXXXXXXXXX
X                  X
XXXXXXXXXXXXXXXXXXXX